11
36
XXXXXXXXXXXXXXXXXXXXXXXXXXXXXXXXXXXX
X     XXXXXXXX         FXXXXXXXX XXX
XXXXX XXXXXXXX XXXXXXXXSXXXXXXXX XXX
XXXXX XXXXXXXX XXXXXXXXXXXXXXXXX XXX
XX     XXX     XXXXX     XXX     XXX
XX XXX XXX XXXXXXXXX XXX XXX XXXXXXX
XX XXX XXX XXXXXXXXX XXX XXX XXXXXXX
XX XXX XXX XXXXXXXXX XXX XXX XXXXXXX
XXSXXX XXX XXXXXXXXX XXX XXX XXXXXXX
XXXXXX               XXX           X
XXXXXXXXXXXXXXXXXXXXXXXXXXXXXXXXXXXX
