10
15
XXXXXXXXXXXXXXX
X             X
X   XXXX      X
X   XXXX      X
X     XX      X
X     XX      X
XXXXXXXX   S  X
F             X
X             X
XXXXXXXXXXXXXXX